M            - M is a programming language developed by Microsoft. The language is designed specifically for building textual domain-specific 
M2001        - M2001 is a modular educational mathematical programming language for developing and presenting mathematical algorithms.
M4           - m4 is a general purpose macro processor designed by Brian Kernighan and Dennis Ritchie. 
Machine code - Machine code or machine language is a set of instructions executed directly by a computer's central processing unit (CPU).
MAD          - Michigan Algorithm Decoder.It is a programming language and compiler for the IBM 704.
MAD/I        - Same as above
Magik        - Magik is an object-oriented programming language that supports multiple inheritance, polymorphism and is dynamically typed.
Magma        - Magma is a computer algebra system designed to solve problems in algebra, number theory, geometry and combinatorics.
make         - In software development, Make is a utility that automatically builds executable programs and libraries from source code.
Maple        - Maple is a commercial computer algebra system. It was first developed in 1980 by the Symbolic Computation Group.
MAPPER       - MAPPER (MAintain, Prepare, and Produce Executive Reports) is a database management and processing system. 
MARK-IV      - MARK IV is a Fourth-generation programming language that was created by Informatics, Inc. (later, Sterling Software) 1960s. 
Mary         - Mary was a programming language designed and implemented by RUNIT at Trondheim, Norway in the 1970s. 
MASM         - The Microsoft Macro Assembler (MASM) is an x86 assembler that uses the Intel syntax for MS-DOS and Microsoft Windows. 
Mathematica  - Mathematica is a computational software program used in scientific, engineering, and mathematical fields.
MATLAB       - MATLAB (matrix laboratory) is a numerical computing environment and fourth-generation programming language. 
Maude        - The Maude Programming Langauge.
Maxima       - Maxima is a computer algebra system based on a 1982 version of Macsyma. It is written in Common Lisp and runs on all POSIX.
Max          - Max is a visual programming language for music and multimedia developed and maintained by San Francisco-based software .
MaxScript    - Autodesk 3ds Max, formerly 3D Studio Max, is 3D computer graphics software for making 3D animations, models, and images.
Maya (MEL)   - The Maya Embedded Language (MEL) is a scripting language used to simplify tasks in Autodesk's 3D Graphics Software Maya. 
MDL          - MDL (the MIT Design Language) is a descendant of the Lisp programming language. 
Mercury      - Mercury is a functional logic programming language geared towards real-world applications.
Mesa         - Mesa was an innovative programming language developed in the late 1970s at the Xerox Palo Alto Research Center in Palo Alto.
Metacard     - MetaCard was a cross-platform, commercial GUI toolkit. MetaCard included an IDE and had its own language, MetaTalk. 
Metafont     - Metafont is a description language used to define vector fonts. It is also the name of the interpreter that executes Metafont 
MetaL        - The Meta-programming Language is a programming language designed for meta-programming.
Microcode    - A microassembler is a computer program that helps prepare a microprogram to control the low level operation of a computer.
MicroScript  - The MicroScript PL is a graphically-oriented, high-level PL created by Personal Media Corporation for TRON.
MIIS         - MIIS (Meditech Interpretive Information System) is a MUMPS-like programming language developed by Meditech in the 1970s. 
MillScript   - MillScript is a computer programming language for the batch production of templated Web sites.
MIMIC        - MIMIC, known in capitalized form only, is a former simulation computer language developed 1964 by H. E. Petersen.
MIPS ASM     - Assembly langauge to program MIPS family of microprocessors.
Mirah        - Mirah (formerly known as Duby) is a programming language based on Ruby syntax, local type inference, hybrid static.
Miranda      - Miranda is a non-strict purely functional programming language designed by David Turner .
MIVA Script  - Miva Script is a proprietary computer scripting language mainly used for internet applications such as e-commerce.
ML           - ML is a general-purpose functional programming language developed by Robin Milner and others in the early 1970s.
Moby         - The Moby programming language is an experiment in computer programming, design and implementation.
Model 204    - Model 204 is a database management system for IBM and compatible mainframe computers.
Modelica     - Modelica is an object-oriented, declarative, multi-domain modeling language for component-oriented modeling .
Modula       - The Modula programming language is a descendent of the Pascal programming language.
Modula-2     - Modula-2 is a computer programming language designed and developed between 1977 and 1980 by Niklaus Wirth.
Modula-3     - In computer science, Modula-3 is a programming language conceived as a successor to an upgraded version of Modula-2 .
MOO          - The MOO programming language is a relatively simple programming language used to support the MOO Server.
Mortran      - Mortran (More Fortran) is an extension of the Fortran programming language used for scientific computation.
Mouse        - The Mouse programming language is a small computer programming language developed by Dr. Peter Grogono.
MPD          - Multithreaded, Parallel, and Distributed programming (MPD) is a concurrent programming language.
MSDOS        - Microsoft Disk Operating System Batch Programming.
MSL          - The mIRC scripting language, often unofficially abbreviated to 'mSL, is the scripting language embedded in mIRC
MUF          - MUF (Multi-User Forth) is the Forth-like programming language invented in 1990 for multi-user role playing system 
MUMPS        - MUMPS (Massachusetts General Hospital Utility Multi-Programming System) 
MYTHRYL      - Mythryl is a general-purpose, modular, functional programming language with compile-time type checking.
