PARI/GP       - PARI/GP is a computer algebra system with the main aim of facilitating number theory computations.
Parrot        - Parrot is an assembly programming lanaguge.
Pascal        - Pascal is an influential imperative and procedural programming language, designed in 1968–1969 .
Pawn          - Pawn, formerly known as Small, is an open source scripting language primarily intended as an embeddable scripting language.
PCASTL        - The PCASTL (an acronym for by Parent and Childset Accessible Syntax Tree Language) is an interpreted high-level programming .
PCF           - Programming Computable Functions or PCF, is a typed functional language introduced by Gordon Plotkin in 1977.
PDF           - The PDF Programming Langauge.
PEARL         - PEARL, or Process and Experiment Automation Realtime Language, is a CPL designed for multitasking and real-time programming.
PeopleCode    - PeopleCode is an (ool) object-oriented proprietary (case-insensitive) language used to express business logic.
Perl          - Perl is a family of high-level, general-purpose, interpreted, dynamic programming languages.
PDL           - Perl Data Language (abbreviated PDL) is a set of free software array programming extensions to the Perl programming language.
PHP           - PHP is a server-side scripting language designed for web development but also used as a general-purpose programming language. 
Phrogram      - Phrogram is a commercial programming language designed by its creators to be understandable and appealing to beginners.
Pico          - Pico is a programming language developed at the Software Languages Lab at Vrije Universiteit Brussel.
Pict          - Pict is a statically typed programming language, one of the very few based on the π-calculus. 
Pike          - Pike is an interpreted, general-purpose, high-level, cross-platform, dynamic PL, with a syntax similar to that of C. 
PIKT          - PIKT is cross-categorical, multi-purpose software for global-view, site-at-a-time system and network administration.
PILOT         - Programmed Instruction, Learning, Or Teaching (PILOT) is a simple historic programming language developed in the 1960s.
Pipelines     - A Hartmann pipeline is an extension of the Unix pipeline concept, providing for more complex paths.
Pizza         - Pizza is an open-source superset of the Java with the Generics,Function pointers etc.
PL-11         - PL-11 is a high-level machine-oriented programming language for the PDP-11, developed by R.D. 
PL/0          - At least two programming languages are known as PL/0. One is a subset of IBM's general-purpose programming language PL/I.
PL/B          - Programming Language for Business or PL/B is a business-oriented programming language originally called DATABUS.
PL/C          - PL/C is a computer PL developed at Cornell University with the specific goal of being used for teaching programming. 
PL/I          - The PL/M programming language (an acronym of Programming Language for Microcomputers) is a high-level language.
PL/M          - The PL/P programming language (an acronym of Programming Language for Prime (computers)) is a mid-level programming language.
PL/P          - The PL/P programming language (an acronym of Programming Language for Prime (computers)) is a mid-level programming language .
PL/SQL        - Procedural Language/Structured Query Language (PL/SQL) is Oracle Corporation's procedural extension language for SQL.
PL360         - PL360 is a programming language designed by Niklaus Wirth and written by Niklaus Wirth, Joseph W. Wells, Jr., and Edwin.
PLANC         - PLANC (pronounced as "plank") is a high level computer programming language.
Plankalkül    - Plankalkül (German pronunciation: [ˈplaːnkalkyːl], "Plan Calculus") is a computer language designed for engineering purposes.
PLEX          - Programming Language for EXchanges is a special-purpose, pseudo-parallel and event-driven real-time programming language. 
PLEXIL        - PLEXIL (Plan Execution Interchange Language) is an open source technology for automation by NASA.
Plus          - Plus is a "Pascal-like" system implementation language from the University of British Columbia (UBC).
POP-11        - POP-11 is a reflective, incrementally compiled programming language with many of the features of an interpreted language.
PostScript    - PostScript (PS) is a computer language for creating Vector graphics. It is a dynamically typed, concatenative PL.
Pov-Ray       - The Pov-Ray Programming langauge.
Powerhouse    - PowerHouse is a trademarked name for a byte-compiled fourth-generation PL (or 4GL) originally produced by Quasar Corporation. 
PowerBuilder  - PowerBuilder is an integrated development environment owned by Sybase, a division of SAP.
PowerShell    - Windows PowerShell is Microsoft's task automation framework, consisting of a command-line shell and Shell langauge.
PPL           - The Polymorphic Programming Language (PPL) was developed in 1969 at Harvard University.
Processing    - Processing is an open source programming language and integrated development environment (IDE) built for the electronic arts.
Processing.js - Processing.js is a JavaScript port of Processing, a programming language designed to write visualizations, images etc. 
Profan        - The Profan Programming langauge.
Prograph      - Prograph is a multiparadigm programming language that uses iconic symbols to represent actions to be taken on data.
Progress      - Progress Programming Langauge.
PROIV         - PROIV is a fourth-generation programming language (4GL), developed and sold by NorthgateArinso.
Prolog        - Prolog is a general purpose logic programming language associated with artificial intelligence and computational linguistics.
Visual Prolog - Visual Prolog, also formerly known as PDC Prolog and Turbo Prolog, is a strongly typed object-oriented extension of Prolog.
Promela       - PROMELA (Process or Protocol Meta Language) is a verification modeling language.
PROTEL        - Protel stands for "Procedure Oriented Type Enforcing Language". It is a programming language created by Nortel Networks.
Protocol Buff - The Protocol Buffer programming langauge.
ProvideX      - ProvideX is a computer language and development environment derived from Business Basic .
Pro*C         - Pro*C (also known as Pro*C/C++) is an embedded SQL programming language used by Oracle Database database management systems.
Pure          - Pure is a dynamically typed, functional programming language based on term rewriting.
Pure Basic    - The Pure Basic Programming langauge.
Python        - Python is a general-purpose, high-level programming language whose design philosophy emphasizes code readability.