T            - The T programming language is a dialect of the Scheme programming language developed in the early 1980s.   
TACL         - TACL (the Tandem Advanced Command Language) is the scripting programming language used in Tandem Computers.
TACPOL       - TACPOL (Tactical Procedure Oriented Language) is a block structured programming language developed by the United States Army.
TADS         - Text Adventure Development System (TADS) is a prototype-based domain-specific programming language.
TAL          - Transaction Application Language  is a block-structured, procedural language optimized for use on Tandem System.
Tcl          - TCL pronounced as "tickle" is a scripting language created by John Ousterhout.
Tea          - Tea is a high level scripting language for the Java environment. It combines features of Scheme, Tcl and Java.
TECO         - Tape Editor and COrrector, but later Text Editor and COrrector) is a text editor originally developed at the (MIT) in the 1960s.
TELCOMP      - TELCOMP was a programming language developed at Bolt, Beranek and Newman (BBN) in about 1965.  
Template Tk  - The template Toolkit
TestML       - TestML is an Acmeist, data-driven, unit test language/framework. This means that you can write the same software in many languagues.
TEX          - TeX is a typesetting system designed and mostly written by Donald Knuth.
TI-Basic     - TI-BASIC is the high-level language used on TI-83 and TI-83+ calculators (aside from the assembly which is also on the calculator).
TIE          - Tensilica Instruction Extension refers to the proprietary language that is used to customize the Xtensa processor core architecture.
Timber       - Timber is a functional programming language descendant from O'Haskell, targeted at embedded real-time systems.
Tk           - The Tk is a graphical programming language based on Tcl.
TMG          - TMG is a compiler-compiler created by Robert M. McClure and presented in 1968. and implemented by Douglas McIlroy.
TOM          - Tom is a PL particularly well-suited for programming various transformations on tree structures and XML based documents.
Topspeed     - Same as Charion.
TorqueScript - Torque Script is a Scripting langauge.
TPP          - The Tpp Programming Language.
TPU          - DEC Text Processing Utility  was a language developed by Digital Equipment Corporation (DEC) for developing text editors.
Trac	     - TRAC (for Text Reckoning And Compiling) is a programming language developed in the early 1960s by Calvin Mooers.
Trith        - Trith is an experimental stack-based, concatenative programming language by Arto Bendiken.
TTCN         - TTCN is a programming language used for testing of communication protocols and web services. 
TTM          - TTM is a string oriented, general purpose macro processing programming language developed in 1968 by Steven Caine.
T-SQL        - Transact-SQL (T-SQL) is Microsoft's and Sybase's proprietary extension to SQL. SQL, often expanded to Structured Query Language.
Turing       - Turing is a Pascal-like programming language developed in 1982 by Ric Holt and James Cordy, then of University of Toronto,Canada.
Tuscript     - TUSCRIPT is the scripting language module of TUSTEP (acronym for TUebingen System of TExt processing Programs).
TUTOR        - TUTOR (also known as PLATO Author Language) is a programming language developed for use on the PLATO system at the Univ. of Illinois.
TXL          - TXL is a special-purpose programming language originally designed by Charles Halpern-Hamu and James Cordy .
TypeScript   - TypeScript is a free and open source programming language developed by Microsoft. It is a strict superset of JavaScript.