o:XML         - o:XML is an open source, dynamically typed, general-purpose object-oriented programming language based on XML-syntax.
Oak           - Oak was a programming language created by James Gosling in 1991, initially for Sun Microsystems set-top box project.
Oberon        - Oberon[1] is a programming language created in 1986 by Professor Niklaus Wirth .
Obix          - Its a multi-paradigm langaugage that generates JAVA binaries to run in the JVM.
OBJ2          - OBJ2 is a programming language with Clear-like parametrised modules and a functional system based on equations.
Object Lisp   - Object Lisp was a computer programming language, a dialect of the Lisp language.
ObjectLOGO    - ObjectLOGO is a variant of the programming language Logo with object-oriented programming extensions and lexical scoping.
Object REXX   - The Object REXX programming language is an object-oriented scripting language initially produced by IBM for OS/2.
Object Pascal - Object Pascal refers to a branch of object-oriented derivatives of Pascal, mostly known as the primary programming language.
Objective-C   - Objective-C is a general-purpose, high-level, object-oriented programming language that adds Smalltalk-style messaging to C.
Objective-J   - Objective-J is a programming language developed as part of the Cappuccino web development framework.
Obliq         - Obliq is an interpreted, object-oriented programming language designed to make distributed, and locally multi-threaded.
Obol          - Obol is a high-level security protocol programming language at the Computer Science department of the University of Tromsø.
OCaml         - Objective Caml, is the main implementation of the Caml programming language, created by Xavier Leroy.
occam         - occam is a concurrent programming language that builds on the Communicating Sequential Processes (CSP) process algebra.
Octave        - GNU Octave is a high-level programming language, primarily intended for numerical computations.
OmniMark      - OmniMark is a fourth-generation programming language used mostly in the publishing industry.
Onyx          - Onyx is a stack-oriented programming language.
Opa           - Opa is an open source programming language for developing scalable web applications.
Opal          - OPAL (OPtimized Applicative Language) is a functional PL first developed at the Technical University of Berlin.
OpenEdge ABL  - OpenEdge Advanced Business Language, or OpenEdge ABL for short, is a business application development language.
OpenStep      - The OpenStep programming language.
OPL           - The Open Programming Language (OPL) is an embedded programming language for portable devices that run the Symbian .
OPS5          - OPS5 is a production system computer language, notable as the first such language to be used in a successful expert system,
OptimJ        - OptimJ is an extension of the Java with language support for writing optimization models.
Orc           - Orc is a concurrent, nondeterministic computer programming language created by Jayadev Misra at the University of Texas. 
ORCA/Modula-2 - ORCA/Modula-2 is a Modula-2 compiler written in the Modula-2 programming language for the Apple IIGS computer.
Oriel         - Oriel is a scripting language released with the Power Tools series of instructional books written by the LeBlond Group.
Orwell        - Orwell is a small lazy functional programming language first released in 1984 by Philip Wadler. 
Oxygene       - Oxygene is a programming language developed by RemObjects Software for Microsoft's CLI and Java platform.
Oz            - Oz is a multiparadigm programming language, developed in the Programming Systems Lab at Université catholique de Louvain.
